
NO ./XPM/path_to_the_north_texture.xpm
SO ./XPM/path_to_the_south_texture.xpm
WE                                                         ./XPM/path_to_the_west_texture.xpm
EA    ./XPM/path_to_the_east_texture.xpm

F 0,0,0
C 0a, 0, 0

11111111111111111111111111111
11110111111111011101010010001
1100000011010101110000010001
10000000000000001100000010001
1000000000W000000001010000001
110000011101010111110111100111
11110111 1110101 101111010001
11111111 1111111 111111111111
