
NO ./XPM/path_to_the_north_texture.xpm
SO ./XPM/path_to_the_south_texture.xpm
WE ./XPM/path_to_the_west_texture.xpm
EA ./XPM/path_to_the_east_texture.xpm

F 220,100,0
C 226,30,0

11111111111111111111111111111
11110111111111011101010010001
11000000110101011100000010001
10000000000000001100000010001
10000000000000000001010000001
11000001110101011111011110E0111
11110111 1110101 101111010001
11111111 1111111 111111111111
