
EA ./XPM/path_to_the_east_texture.xpm
NO ./XPM/path_to_the_north_texture.xpm
SO ./XPM/path_to_the_south_texture.xpm
WE ./XPM/path_to_the_west_texture.xpm

F 100,100,200
C 20,000,200

01111111111111111111111111111
1111011111111101110101001001
1100000011010101110000010001
10000000000000001100000010001
10000000000000W00001010000001
11000001110101011110111100111
11110111 1110101 101111010001
11111111 1111111 111111111111
