
EA ./XPM/path_to_the_east_texture.xpm
NO ./XPM/path_to_the_north_texture.xpm
SO ./XPM/path_to_the_south_texture.xpm
WE ./XPM/path_to_the_west_texture.xpm

F 100,100,+200
C 20,000,200

        1111111111111111111111111
        1000000000110000000000001
        1011000001110000000W00001
        1001000000000000000000001
1111111110011000001110000000000001
100000000011000001110111111111111
11110111111110011100000010001
11110111111111011101010010001
110000001101 1011100100010001
10000000000010000000000010001
10000000000000001101010010001
110000011101010111110111100111
11110111 1110101 101111010001
11111111 1111111 111111111111