
EA ./XPM/path_to_the_east_texture.xpm
NO ./XPM/path_to_the_north_texture.xpm
SO ./XPM/path_to_the_south_texture.xpm
WE ./XPM/path_to_the_west_texture.xpm

F 100,100,200
C 20,000,200

0111111111111111111111111111
101011111111101110101001001
1000000110101011100000100001
1000W00000000001100000010001
10000000000000000001010000011
110000011101010010001111001
11110101 1110101 10100000001
11111111 1111111 1111111111
