
NO ./XPM/path_to_the_north_texture.xpm
SO ./XPM/path_to_the_south_texture.xpm
WE ./XPM/path_to_the_west_texture.xpm
EA ./XPM/path_to_the_east_texture.xpm

F 58,57,35
C 0,127,255

11111111111111111111111111111
11110111111111011101010010001
11000000110101011100000010001
10000000000000001100000010001
10000000000000000001010000001
1100000111010101111101111E00111
11110111 1110101 101111010001
11111111 1111111 111111111111
